NO ./Texture/colorstone.xpm
SO ./Texture/redbrick.xpm
WE ./Texture/wood.xpm
EA ./Texture/greystone.xpm

F 100,100,100
C 50,50,50""

 1111111111111111111111111
 1000000000  0000000000001
 10110000W   0000000000001
1100100000000000000000000111111111
111111111011000001110000000000001
10000000001100000111011111 111111
11110111111111011100000010001
11110111111111011101010010001
11000000110101011100000010001
1000000000000 001100000010001
10000000000000001101010010001
1100000111010101111101111000111
11110111 1110101 101111010001
11111111 1111111 111111111111